11111111111111111111
1.8,1...1.....8...61
1...1........4..9..1
1...16.81....9..5..1
1...11111..........1
1..........6.......1
1.5................1
18.......9.9.9.....1
1..................1
17..1..........1...1
1...1..........1...1
1...1....6.96.71...1
1...111111111111...1
1....6..81.........1
1...94...1.........1
1........17..5.....1
111......1...9...111
1........18........1
32.......1....76...3
11111111111111111111