11111111111111111111
16......176.4......1
14.5....15.........1
1.5................1
1...........4......1
16.8....1..8......71
1111..1111111..11111
1.7......4..1.....81
1.8.........1......1
1....61.....1......1
1....91.....19..5.91
1.....16....19....91
1.....1....816....91
1.....1.....19....91
19....1.....1......1
16...91.....1......1
1.....1............1
1.....1............1
32....176...8......3
11111111111111111111