11111111111111111111
18..........47.7..61
1.........76.......3
1111..11111111111111
1......8.........1.1
16..........199..181
1..........61....1.1
1111...111111..999.1
16.4......6.1......1
1645.1.4.4.61...5..1
18...16756581......1
11111111111116.....1
18..........17.....1
1.5.4...5.6.8...9991
1..........61.....61
1..........61999...1
1111...111111......1
18.................1
32.................1
11111111111111111111